14 15 15 15 15 15 15 15 15 15 15 15 15 15 15 15 15 15 15 16
34 86 86 86 86 86 86 86 86 86 86 86 86 86 86 86 86 88 86 36
34 86 86 86 90 86 86 86 86 86 86 86 86 86 86 86 86 86 86 36
34 86 86 86 86 86 86 86 86 86 86 86 86 86 86 86 86 86 86 36
34 86 86 86 86  0  2  2  2  2  2  2  2  2  4 86 86 86 86 36
34 86 86 86 86 40 42 42 42 42 42 42 42 42 44 86 86 86 86 36
34 86 86 86 86 40 42 42 42 42 42 42 42 42 44 86 86 86 86 36
34 86 86 86 86 40 42 42 42 42 42 42 42 42 44 86 86 86 86 36
34 86 86 86 86 40 42 42 196 42 42 42 42 42 44 86 86 86 86 36
34 86 86 86 86 40 42 42 42 42 42 42 42 42 44 86 86 86 86 36
34 86 86 86 86 40 42 42 42 42 42 42 42 42 44 86 86 86 86 36
34 86 86 86 86 80 82 82 82 82 82 82 82 82 84 86 86 86 92 36
34 86 86 86 86 86 86 86 86 86 86 86 86 86 86 86 86 86 86 36
34 86 86 86 86 86 86 86 86 86 86 86 86 86 86 86 86 86 86 36
34 86 86 86 86 86 86 86 88 86 86 86 86 86 86 86 86 86 86 36
54 55 55 55 55 55 55 55 55 55 55 55 55 55 55 55 55 55 55 56